to concern sb./sth. [relate to]	jdn./etw. anbelangen
to confess	beichten
to mull [rare] [to bungle]	verpatzen [ugs.]
to get off lightly [idiom]	glimpflich davonkommen [Redewendung]
to depose sb.	jdn. seines Amtes entheben
to incite	anstiften
bound  [enchained]	gefesselt
grievances	Missstände {pl}
extent	Ausdehnung {f}
to abut	anliegen
forceps [more than one pair]	Zangen {pl}
likeness	Ebenbild {n}
far-fetched	an den Haaren herbeigezogen [ugs.] [Redewendung]
to be in a sorry state [idiom]	im Argen liegen [Redewendung]
to tower	sich [Akk.] auftürmen
pliability	Biegsamkeit {f}
to tilt	verkanten
gondola	Gondel {f}
to prevail against sb.	jdn. unterkriegen [ugs.]
PowerPoint slides	PowerPoint-Folien {pl}
moniker [coll.] [nickname]	Spitzname {m}
stunning	atemberaubend
retaliation	Heimzahlung {f}
to attain sth.	etw. erlangen
muddleheadedness	Schusseligkeit {f} [ugs.]
board of directors [supervisory board]	Aufsichtsrat {m}
accolade [ceremonial gesture used to confer knighthood]	Ritterschlag {m}
thorough	sorgfältig
to catch the speaker's eye	sich zu Wort melden
to snort	schnauben
to polish up	aufpolieren
to polish up [knowledge]	auffrischen [Kenntnisse]
with a shrug	mit einem Schulterzucken
shrug	Schulterzucken {n}
reprehensible	verwerflich
pertinent	sachdienlich
to target sth.	etw. anstreben
wistful	schwermütig
to veil sb./sth.	jdn./etw. verschleiern
confidence	Zuversicht {f}
to cause sth. [damage, harm, etc.]	etw. anrichten [Schaden, Unheil etc.]
to con sb. [coll.]	jdn. reinlegen [ugs.]
depressed	deprimiert
militant	kämpferisch
intimidated	eingeschüchtert
to disdain	verachten
to despise sb./sth.	jdn./etw. verachten
interpretation	Auslegung {f}
in ruins	in Trümmern
mischief	Unfug {m}
clumsy	tollpatschig [ugs.]
clumsy	unbeholfen
unexpected	unvermittelt
elaborate [esp. of writing]	ausgefeilt [fig.]
to route	lotsen
fitness	Ertüchtigung {f}
sacrosanct	unantastbar
to beg for sth.	um etw. betteln
flattering	schmeichelhaft
rewarding	lohnend
incline	Gefällstrecke {f}
decency	Anstand {m}
small donation	Obolus {m} [kleine Geldspende]
desire	Verlangen {n}
desperately	händeringend [fig.]
custody	Gewahrsam {m}
longing	Verlangen {n} [Sehnsucht]
to attain sth.	etw. erzielen
to score a goal	ein Tor erzielen
to hum [machines, engines]	wummern [ugs.]
to preserve sth. from a bygone era	etw. in die Gegenwart herüberretten
to be accurate	zutreffen [richtig sein]
to grasp sth. in thought	etw. [Akk.] mitbekommen [verstehen]
fabric [underlying structure]	Gefüge {n}
sth. amounts to	etw. läuft hinaus auf
He's resting on his laurels.	Er ruht sich auf seinen Lorbeeren aus.
rudimentarily	ansatzweise
disgust	Ekel {m}
to make out with sb. [Am.] [coll.]	mit jdm. rummachen [ugs.]
to gossip about sth.	etw. durchhecheln [ugs.] [pej.]
to cause a stir	Aufsehen erregen
sensation	Aufsehen {n}
marriage	Trauung {f}
sb. has confessed	jd. hat gestanden [gebeichtet, eingestanden]
forlorn	aussichtslos
tarp [esp. Am.] [coll.] [tarpaulin]	Plane {f}
tattler	Klatschmaul {n} [ugs.] [pej.]
silent vigil	Mahnwache {f}
to scuttle	hoppeln
to fade	verblassen
to appreciate sth. [value highly]	etw. goutieren [geh.] [gutheißen, zustimmen]
to stick	anheften
to scoff [mock]	spötteln
to succeed [be successful]	reüssieren [geh.]
hardly worth mentioning	kaum der Rede wert
to flatter sb.	jdm. schmeicheln [auch Farbe, Licht etc.]
to be out of it [coll.] [idiom] [be unable to think or react properly]	neben der Spur sein [ugs.] [Redewendung]
to come true [prophecy]	eintreffen [sich bewahrheiten] [Prophezeiung]
to rage	toben
to stimulate	aufputschen
at all costs	tunlichst [unbedingt]
to resist	erwehren [geh.]
symbol	Sinnbild {n}
to shuffle off [lazily walk off]	sich [Akk.] trollen [ugs.]
to push off [coll.]	sich trollen [ugs.]
dressed up	aufgebrezelt [ugs.]
erroneous	abwegig [irrig]
to harbour a grudge [Br.]	einen Groll hegen
grudge	Groll {m}
to nurture [idea, ambitions]	hegen
superficial  [fig.]	seicht [fig.]
deceived	hintergangen
naivety	Blauäugigkeit {f}
to slumber	schlummern [geh.]
to bomb [Am.] [coll.] [event]	ein Reinfall sein [ugs.] [Veranstaltung]
to trivialize sth.	etw. [Akk.] bagatellisieren
cesspool	Jauchegrube {f}
to project [jut out]	hinausragen [horizontal]
to attest sth. [prove, demonstrate]	etw. belegen [beweisen]
tower of strength [fig.]	Fels {m} in der Brandung [fig.]
surge [of waves]	Brandung {f}
rock [also fig.]	Fels {m} [auch fig.]
howling	heulend
vanity	Eitelkeit {f}
underachiever	Versager {m}
to idolize sb.	jdn. abgöttisch lieben
villain	Schurke {m}
thraldom	Knechtschaft {f}
gracious [merciful, also: condescending]	gnädig [huldvoll, auch: herablassend]
bank	Schräglage {f}
to hush sth. (up) [keep from public knowledge]	etw. [Akk.] totschweigen
exhausted	matsch [ugs.] [prädikativ: matsch sein; adverbial: sich matsch fühlen; nicht attributiv]
spellbound	gebannt
giddy	schwindlich [veraltet]
across / against the grain [also fig.]	gegen den Strich [auch fig.]
competitor	Mitbewerber {m}
to boost	ankurbeln
rule of thumb	Faustformel {f}
to make sb. chuckle	jdn. zum Schmunzeln bringen
to smirk	schmunzeln
to scandalize	anecken [ugs.]
dopey  [coll.]	verpeilt [ugs.]
infatuation	Schwärmerei {f}
indomitable	unbezwingbar
to fade	verbleichen
to saw sth. up	etw. zersägen
pejorative	abwertend
meaningless [purely formal, clichéed]	floskelhaft [pej.]
ambiguous	mehrdeutig
proper	gehörig
to riot	sich austoben
balancing act [fig.]	Spagat {m} [fig.]
cheek [impertinence]	Frechheit {f}
execution [killing]	Hinrichtung {f}
He can't sing to save his life. [coll.]	Er kann ums Verrecken nicht singen. [ugs.] [derb]
to kick the bucket [coll.] [idiom]	verrecken [ugs.]
rags [also coll.: clothes]	Fetzen {pl} [ugs.] [auch Klamotten]
right away	auf Anhieb [Redewendung]
unashamed	ungeniert
to swear [thus trying to provoke]	pöbeln
obsolete	hinfällig [nicht mehr aktuell]
idle	müßig [geh.]
bummer [Am.] [coll.] [loafer, idler]	Müßiggänger {m} [geh.]
to blame	tadeln
odd	eigentümlich
to lurk	lauern
merciless	gnadenlos
scattered	versprengt
inferno	Hexenkessel {m}
pitch-black	stockfinster [ugs.]
hoax	Scherz {m}
nuts [coll.]	panne [ugs.]
to elope [run away, abscond]	abhauen [ugs.] [verschwinden, sich davonmachen]
Rumor has it (that) ... [Am.]	Man munkelt, (dass) ... [ugs.]
for the purpose of	zwecks [+Gen.]
to bribe sb.	jdn. schmieren [ugs.] [bestechen]
bleak	trostlos
delusion	Einbildung {f}
characteristic	Ausprägung {f}
to develop	sich ausprägen
volatility	Flüchtigkeit {f}
jacket	Sakko {m} {n}
to work (well)	hinhauen [ugs.]
That should do the job. [coll.]	Damit müsste es hinhauen. [ugs.]
to be sorely mistaken	sich gewaltig irren [ugs.]
to stoop low	Kreide fressen [ugs.]
to surround	umzingeln
tremor	Beben {n}
to put up with sth.	sich [Akk.] mit etw. [Dat.] abfinden
committee	Gremium {n} [Ausschuss]
to draw [attract]	anlocken
to accomplish	bewerkstelligen
battered [damaged]	ramponiert
to draw on unlimited resources	aus dem Vollen schöpfen [Redewendung]
burden	Joch {n} [fig.]
good character	guter Leumund {m}
ways [customs]	Sitten {pl} [Gepflogenheiten]
star jumps {pl}	Hampelmann {m}
cobbler	Schuster {m}
from the cradle to the grave	von der Wiege bis zur Bahre
barley [Hordeum vulgare]	Gerste {f}
while plastered [coll.]	im Suff [ugs.]
affable	umgänglich
incomer [Br.]	Zuzügler {m}
to exude sth. [fig.]	etw. ausstrahlen [fig.]
sleeping beauty slumber	Dornröschenschlaf {m}
to manage sth.	etw. [Akk.] hinkriegen [ugs.]
hub	Drehscheibe {f} [a. fig.]
to be indignant at sth.	sich [Akk.] über etw. [Akk.] empören
simplistic	grob vereinfachend
squeamish	zimperlich [empfindlich]
ponderous [slow, clumsy, sedate]	behäbig [schwerfällig]
pliers {pl} [one pair]	Zange {f}
volunteer	ehrenamtlich
scuffle [brawl]	Handgemenge {n} [Handgreiflichkeiten]
postmortem	Obduktion {f}
to spare no effort to do sth.	alles daransetzen, etw. zu tun
to scurry	wuseln
to catch a breath	durchatmen
gutter [also fig.]	Gosse {f} [auch fig.]
precise	klar umrissen
to besiege	belagern
to slander	lästern
in a hurry	Hals über Kopf [ugs.] [Redensart]
Cross my heart (and hope to die)!	Ich schwöre! [ugs.]
egregious [formal]	ungeheuerlich
quite frankly	offen gestanden [offen gesagt]
given	in Anbetracht [+Gen.]
blatant	eklatant [Fehler]
lurking	schlummernd [versteckt, lauernd]
to differ	abweichen [sich unterscheiden]
skewed	schräg
to cudgel	prügeln
dictum	geflügeltes Wort {n}
to stir sth. [imagination]	etw. [Akk.] anregen [Phantasie]
oath	Eid {m}
template	Schablone {f}
to be out of place [idiom]	fehl am Platz / Platze sein [Redewendung]
stooge	Handlanger {m}
to inculcate sb. with sth.	jdm. etw. einschärfen
to discuss sth. [topic etc.]	sich [Akk.] mit etw. [Dat.] auseinandersetzen [Thema usw.]
to bow down before / to sb./sth. [also fig.]	sich [Akk.] vor jdm./etw. verneigen [auch fig.]
without a hitch	wie geschmiert [ugs.]
rough [brutal]	rabiat
monastery [attr.]	Kloster-
humility	Demut {f}
beyond	jenseits [+Gen.]
flaw	Manko {n}
jamboree	große Sause {f} [ugs.]
deadening [of feelings, sympathy, etc.]	Abstumpfung {f}
to tend [person, views etc.]	neigen [zu etw.]
assertive	durchsetzungsstark
to spill the beans [coll.] [fig.] [idiom] [betray incriminating information]	auspacken [ugs.] [fig.] [inkriminierende Geheimnisse verraten]
up the creek (without a paddle) [coll.]	(völlig) aufgeschmissen [ugs.]
horror	Entsetzen {n}
slaps in the face	Ohrfeigen {pl}
shrugged	gezuckt
bruise	Prellung {f}
spoiled	verdorben
to thwart sb.	jdn. ausbremsen [ugs.]
obsequious	unterwürfig
penalty fare	erhöhtes Beförderungsentgelt {n}
goodwill [of a company]	Kulanz {f}
to substantiate sth. [corroborate, support]	etw. [Akk.] untermauern [fig.]
to con [coll.]	übertölpeln
to show sb. sth.	jdm. etw. vormachen [ugs.] [als Beispiel dienen]
to be able	imstande sein
to work meticulously	tüfteln
to help oneself	zulangen
predictable [person]	durchschaubar
envious	neidisch
to quilt	wattieren
to wrap up [in warm clothing, blankets etc.]	sich einmummeln [ugs.] [in warme Kleidung, Decken etc.]
seminal	bahnbrechend
profound	fundiert
written off	totgesagt [fig.]
awkward [of movements]	eckig [Bewegungen]
myth [fig.] [popular misconception]	Mär {f} [fig.] [Irrglaube]
the essential thing	das A und O {n} [Redewendung]
to use torture	die Folter anwenden
welfare	Wohlergehen {n}
flimsy [pej.] [argument, excuse, etc.]	fadenscheinig [fig.] [pej.] [Argument, Ausrede etc.]
being [existence]	Dasein {n}
envy	Neid {m}
celibacy	Zölibat {m} {n}
prankster	Schelm {m}
segregated	abgesondert
to omit sth. [miss, fail to do]	etw. [Akk.] versäumen
peculiar	absonderlich
unison	Einklang {m}
to dig sth. up [e.g. a cigarette from one's pocket]	etw. hervorkramen [ugs.]
to go to rack	verlottern [ugs.]
to suffer a loss	einbüßen
to take (a) breath	(sich [Akk.]) verschnaufen
unprofessional	laienhaft
to infect sb./sth.	jdn./etw. durchseuchen [infizieren]
brash [way of talking]	schnodderig [ugs.] [pej.]
illogical	ungereimt [nicht stimmig]
chimney	Schornstein {m}
to smooth	ebnen
to rebel	sich auflehnen
essential	unerlässlich
to look good enough to eat [person] [coll.]	zum Anbeißen aussehen [ugs.]
to sketch sth. [also fig.: outline]	etw. [Akk.] skizzieren [auch fig.: umreißen, kurz schildern]
to engage sb.	jdn. anheuern
to be on one's last legs [idiom]	auf dem Zahnfleisch kriechen [Redewendung]
hypocritical	scheinheilig
to chum up (with sb.) [Br.] [coll.] [curry favour with sb.]	sich [Akk.] (jdm.) anbiedern
heavy	bleiern [fig.] [Schlaf, Augenlider usw.]
sb. created	jd. schuf
imperturbable	unbeirrbar
to oust	verdrängen
honorless  [Am.]	ehrenlos
to falter	wanken
to be in a filthy mood [Br.] [coll.]	total miese Laune haben [ugs.]
in the middle of nowhere	janz weit draußen <jwd> [ugs.]
to vanish	vergehen
to catch a plane	ein Flugzeug erwischen [ugs.]
sth. is drawing to an end	etw. neigt sich dem Ende zu [fig.] [geh.]
intimidating	einschüchternd
to chug sth. [Am.] [coll.] [drink in one go]	etw. exen [ugs.]
to clear out a wardrobe	einen Schrank ausmisten [salopp] [Kleidung aussortieren]
to beef [coll.]	meckern [ugs.]
to hang around together [coll.]	aufeinander hocken [ugs.] [alt]
endearment	Zärtlichkeit {f}
inevitably	unweigerlich
to ebb away	abebben
to take sth. in stride [Am.] [idiom]	mit etw. [Dat.] gut klarkommen
uncouth	flapsig [ugs.]
withdrawal symptom	Entzugserscheinung {f}
As if! [coll.]	Von wegen! [ugs.]
to imagine	wähnen [geh.]
to pick oneself up [to brace oneself physically / mentally]	sich aufrappeln [ugs.] [sich aufraffen]
He's pig-headed.	Er hat einen Dickschädel.
somber  [Am.]	trist
subterfuge	Ausflucht {f}
trifle	Belanglosigkeit {f}
to make sb. get going [idiom]	jdn. auf Trab bringen [ugs.] [Redewendung]
to return the favor [Am.]	den Gefallen erwidern
rigmarole [coll.] [fuss, ado, needless motion]	Brimborium {n} [ugs.]
to fondly hope to get sth.	sich [Dat.] etw. erhoffen
to hope for sth. (from sb./sth.)	sich [Dat.] etw. (von jdm./etw.) erhoffen
to run riot [idiom]	über die Stränge schlagen [ugs.] [Redewendung]
useless stuff	unnützes Zeug {n}
lofty	erhaben
detectable	auffindbar
backdrop [also fig.] [of landscape, scenery]	Kulisse {f} [auch fig.] [Landschaft, Umgebung]
to collect	zusammensuchen
to shape	fräsen [Holz]
to notch	kerben
newcomer	Zugezogener {m}
to daze	betäuben
brute [force etc.]	brachial
rough	rau
cipher	Chiffre {f}
replenishment	Nachschub {m}
to hunt for sb./sth.	nach jdm./etw. fahnden
to consecrate sb./sth.	jdn./etw. weihen
to demoralize	zermürben
to be a burden on sb.	jdm. zur Last fallen [Redewendung]
proscribed	verpönt
French fry stall [Am.]	Pommes-frites-Stand {m} [seltener für: Pommesbude]
to cling	sich anschmiegen
nasty	garstig
to become known	ruchbar werden [geh.]
long-cherished	lang gehegt
to revolt	aufbegehren
to blame sb. for sth.	jdm. etw. verübeln
weal and woe [poet.]	Wohl {n} und Wehe
to wish for sth.	nach etw. [Dat.] begehren
to desire sb./sth.	jdn./etw. begehren [geh.]
copyright	Urheberrecht {n}
predicament	Zwickmühle {f} [fig.]
tricks	Kniffe {pl}
hangover [custom etc. that survives from the past]	Überbleibsel {n} [ugs.] [fig.]
brutal	knallhart [ugs.]
looked at more closely	bei näherem Hinsehen
turmoil	Aufruhr {m}
reasonable [adequate, fair]	zumutbar [Arbeit]
Imagine!	Stell dir vor!
at call	auf Abruf
velvet gloves	Samthandschuhe {pl}
to be intimate with sb.	mit jdm. buhlen [veraltet]
to tackle [make a sliding tackle]	grätschen
pincer grip	Zangenangriff {m}
protracted	langwierig
simply	schlicht und ergreifend [ugs.] [hum.]
to prevail	obsiegen [veraltend]
to avoid sb./sth. like the plague	jdn./etw. meiden wie der Teufel das Weihwasser
agitated	aufgewühlt
apprehensive	bange
to deny	bestreiten
to make a fuss	Tamtam machen [ugs.]
to puzzle over sth.	an etw. [Dat.] tüfteln [ugs.] [geistig]
validity	Aussagekraft {f}
distorted  [face etc.]	verzerrt
fortitude	Tapferkeit {f}
irrevocable	unwiderruflich
obnoxious	anstößig
deplorable	bedauerlich
candor [Am.]	Aufrichtigkeit {f}
prosperity	Wohlstand {m}
peers [fellow experts]	Fachleute {pl}
compensation	Entschädigung {f}
aspiration	Anspruch {m} [Ambition, Bestreben]
scorn	Gespött {n}
pathogen	Erreger {m}
impostor	Hochstapler {m}
recast	Nachguss {m}
ambitious	ehrgeizig
slighted [disparaged]	herabgewürdigt
mesmerized  [fig.]	gebannt [fig.]
to generalize	pauschalisieren [stark verallgemeinern, z. B. eine Aussage]
inhibition	Hemmung {f}
to prefer	vorziehen
garment	Gewand {n} [geh. oder regional]
to schedule [meeting, appointment]	ansetzen
obliterating	tilgend
sincere	aufrichtig
devious	abwegig
muddy	trübe
after all this time	nach all dieser Zeit
unflattering [dress, makeup, portrait, light, etc.]	unvorteilhaft [Kleid, Make-up, Porträt, Licht etc.]
model state	Musterstaat {m}
former glory	alte Pracht {f}
bread crumbs	Brosamen {pl} [geh.] [veraltend]
arbiter	Vermittler {m}
to tick away [time, minutes, life, etc.]	verstreichen [Zeit, Minuten, Lebenszeit etc.] [vergehen]
nemesis	Erzfeind {m}
to divide into	einteilen in
celebrity	Promi-
working class	Arbeiterschicht {f}
to check on the Internet	im Internet nachschauen [bes. südd., österr. und schweiz.]
reception	Empfang {m}
bulky	sperrig
to whine	quengeln [ugs.]
intake	Zulauf {m}
disguise	Tarnung {f}
hesitant	zögerlich
quotation	Aktienkurs {m}
failure	Reinfall {m} [ugs.]
fellow students	Kommilitonen {pl}
currently	gegenwärtig
to embrace sth. [an idea, a plan etc.]	etw. [Akk.] annehmen [einverstanden sein, übernehmen]
Whatever. [coll.]	Meinetwegen. [ugs.]
to play poker	pokern
embellishment	Verzierung {f}
brass	Messing-
to pretend sth.	etw. vorgeben [vorspiegeln]
rein	Zügel {m}
Giddyup! [Am.]	Hü! [Ruf, um ein Pferd anzutreiben]
enacted	verordnet
atrial fibrillation <AF>	Vorhofflimmern {n}
outpatient	ambulant
to enshrine sth. [rights in law etc.]	etw. [Akk.] verankern [Rechte etc.]
leftovers	Ladenhüter {pl}
to overexert sb./sth.	jdn./etw. überfordern
friction	Reibung {f} [auch fig.]
patch	Aufnäher {m}
to happen	sich zutragen [geh.]
fleeting	flüchtig [Blick, Eindruck, Moment etc.]
to change	sich [Akk.] wandeln
meticulous	akribisch [geh.]
to refresh	auffrischen [auch fig.]
to tremble	zittern
to devote	widmen
sth. oscillates	etw. schwingt
shameful	schambehaftet
Snap out of it!	Reiß dich zusammen! [fig.]
affiliation	Zugehörigkeit {f}
to blunder [make a stupid or careless mistake]	patzen [ugs.] [kleinere Fehler machen, fehlerhaft arbeiten]
elongated	länglich
rambles	schweift
to fleece sb. [coll.] [fig.]	jdn. abzocken [ugs.]
diminutive	zierlich
sb. becomes nauseated	jd. ekelt sich
brutally honest	schonungslos ehrlich
representative	maßgeblich
vivid	lebhaft
to stir [awaken]	wachrütteln
invented	erfunden
responsive (to sth.)	empfänglich (für etw. [Akk.])
not to mention ...	geschweige denn ...
to take vengeance	sich rächen
to befall [fate] [literary]	ereilen [geh.]
to manage sth. [succeed in dealing with sth.]	etw. bewältigen
barren	karg
square [coll.] [boringly traditional]	spießig [ugs.] [pej.]
to degrade	entwürdigen
mental acuity	Scharfsinnigkeit {f} [Scharfsinn]
gruff	ruppig
nausea	Übelkeit {f}
to alleviate	lindern
to determine	eruieren
to serenade sb.	jdm. ein Ständchen bringen
embarras de choix	die Qual {f} der Wahl
lenient	glimpflich
jealousy	Eifersucht {f}
Don't meet trouble halfway!	Malen Sie nicht den Teufel an die Wand!
to read up on a subject	sich in ein Thema einlesen
sb. vows	jd. schwört
to game [coll.] [play computer games]	zocken [ugs.] [Computerspiele spielen]
to knock sb.'s socks off [coll.]	jdn. vom Hocker hauen [ugs.]
slog	Maloche {f} [ugs.]
dozily	verpennt [ugs.]
to goof [esp. Am.] [coll.] [make a mistake]	es vermasseln [ugs.]
assertive	durchsetzungsfähig
insidious	heimtückisch
to compete	konkurrieren
to exercise	Sport treiben
condolence	Beileid {n}
boggy	sumpfig
to end in	münden in
to manifest [itself]	einleuchten
to exact	abverlangen
futile	vergeblich
cellmate	Zellengenosse {m}
conspecifics	Artgenossen {pl}
to gauge [situation]	abwägen
Beats the hell out of me. [coll.] [idiom]	Ich habe keinen blassen Schimmer. [ugs.] [Redewendung]
to catch up on some sleep	etwas Schlaf nachholen
Forewarned is forearmed.	Gefahr erkannt, Gefahr gebannt.
with hindsight	im Nachhinein
to pass sentence	ein Urteil verkünden
to waste an opportunity	eine Gelegenheit verstreichen lassen
to complain to the police	Anzeige erstatten
Sparks were flying.	Es flogen die Funken.
to be very popular	großen Zulauf haben
to stave off sb. [put off]	jdn. vertrösten
to switch to sth. [jobwise]	auf etw. [Akk.] umsatteln [ugs.] [Redewendung]
to cut sb.'s wings [idiom]	jdm. die Flügel stutzen [Redewendung]
I will make ends meet. [idiom]	Ich werde schon über die Runden kommen. [Redewendung]
That's sheer robbery.	Das ist der reinste Wucher.
That's extortionate!	Das ist Wucher!
teeth-gnashingly	zähneknirschend [fig.]
begging for food [by people]	Betteln {n} um Essen
just the opposite	genau umgekehrt
sth. fluctuates	etw. schwankt
I'm well aware that ...	Mir ist sehr wohl bewusst, dass ...
I am not aware of that.	Ich bin mir dessen nicht bewusst.
I'm shit-scared of him! [vulg.]	Ich habe Schiss vor ihm! [vulg.]
to be stumped [coll.]	ratlos sein
to come up with the money	das Geld auftreiben [ugs.]
to be on one's last legs [idiom]	auf dem Zahnfleisch gehen [Redewendung]
to have sb./sth. on one's hands	jdn./etw. an der Backe haben [bes. nordd.] [ugs.] [am Hals haben]
to come to one's senses [idiom]	zur Vernunft kommen [Redewendung]
to leave sb. high and dry [fig.]	jdn. im Stich lassen [fig.]
to start an argument	einen Streit inszenieren
sorely afflicted	übel heimgesucht
to cause (sb.) discomfort	(jdm.) Unbehagen bereiten
to take (sb.) a lot of effort [to do sth.]	(jdn.) viel Überwindung kosten
to clash	aneinander prallen
It strikes me that ...	Es fällt mir auf, dass ...
to capitalize	großschreiben
complexity	Vielschichtigkeit {f}
to flounder	sich verhaspeln
to slip out	herausrutschen
involuntary	unbeabsichtigt
to clap	klatschen
valley	Tal {n}
patron	Schirmherr {m}
ambush position [e.g. of a cat, snake]	Lauerstellung {f} [z. B. einer Katze, Schlange]
ravine	Schlucht {f}
martinet	Zuchtmeister {m}
decidedly	ausgesprochen
veil	Schleier {m}
looking-glass world	verkehrte Welt {f}
stay	Aufenthalt {m}
to have stranger anxiety	fremdeln
infatuated	verknallt [ugs.]
detail	Ausführlichkeit {f}
conversational tone	Gesprächston {m}
bombshell [fig.] [sensation]	Paukenschlag {m} [fig.]
tantrum	Wutanfall {m}
I couldn't help laughing.	Ich konnte mir das Lachen nicht verkneifen. [ugs.]
syllable	Silbe {f}
patronizingly	von oben herab
hungover [coll.]	verkatert [ugs.]
unique	einzigartig
scarcity	Knappheit {f}
in moderation	in Maßen
bespoke [Br.]	maßgeschneidert
extensive	ausführlich
proposition [argument]	These {f}
to inhibit	hemmen
to illustrate	veranschaulichen
to remove sth.	etw. entfernen
to collect sth. [taxes, an amount of money, news, etc.]	etw. [Akk.] einsammeln
both ... and	sowohl ... als auch
myth [fig.] [untrue, but widely believed]	Märchen {n} [fig.] [Irrglaube]
stroke	Schlaganfall {m}
clot	Gerinnsel {n}
available	vorhanden
in the long run [idiom]	auf Dauer [Redewendung] [auf lange Sicht]
to deposit	ablagern
to escape	entkommen
serene	heiter [ausgeglichen]
to foam (up)	aufschäumen
at any price [idiom]	koste es, was es wolle [Redewendung]
intoxicating	berauschend
paralysis	Lähmung {f}
requirement	Voraussetzung {f}
indigestion {sg}	Verdauungsbeschwerden {pl}
spread	Brotaufstrich {m}
hips	Hüften {pl}
fare [food] [also fig.]	Kost {f} [auch fig.]
to ignite sth. [also fig.]	etw. entzünden [geh. auch fig.]
conversion	Umstellung {f}
intestinal	Darm-
truism	Binsenwahrheit {f}
quote	Spruch {m} [Zitat]
ancient	uralt
sth. smacked of sth. [fig.] [suggested sth.]	etw. roch nach etw. [Dat.] [ugs.] [fig.]
caterpillar [insect]	Raupe {f}
to soak	einweichen
to draw a bath	Badewasser einlassen
to touch	berühren
to top	überragen
superior  [excellent]	überragend
probe	Fühler {m}
snail	Schnecke {f}
to embed	einbetten
tremor	Erschütterung {f} [des Bodens etc.]
concussion	Erschütterung {f}
to commit sth. [crime etc.]	etw. begehen [Straftat etc.]
onslaught	Ansturm {m} [Anstürmen]
to achieve	verwirklichen [Ziele]
mob	Meute {f}
tremendous	ungeheure
fallacy	Irrtum {m}
sb. muzzles [fig.]	jd. macht mundtot [fig.]
hubris	Anmaßung {f}
to claim sth.	etw. [Akk.] beanspruchen
hubris	Selbstüberhebung {f}
preferably	vorzugsweise
to bend over backwards [idiom]	sich verbiegen [fig.]
dwarf	Zwerg {m}
figure [personality, character in a novel etc.]	Gestalt {f} [Person, Persönlichkeit, Figur in einem Roman etc.]
vogue expression	Modebegriff {m}
to put it mildly	gelinde gesagt
advocate	Verfechter {m}
determination	Festlegung {f}
to begin with	zunächst einmal
to try	sich bemühen
sustained	anhaltend
gloom	Trübsinn {m}
glacier	Gletscher {m}
digger	Bagger {m}
boulder	Findling {m}
regulation	Vorschrift {f}
to relocate	versetzen
controversial	brisant
not only ... (but) also	nicht nur ..., sondern auch
ambitious [target, project, etc.]	anspruchsvoll [Ziel, Projekt etc.]
incessantly	unentwegt [unaufhörlich]
lifestyle	Lebenswandel {m}
to preach	predigen
interference	Einmischung {f}
landfills	Deponien {pl}
infinite loop	Endlosschleife {f}
spat [quarrel, short argument]	Zank {m} [bes. um Nichtigkeiten]
fuse	Zündschnur {f}
pushups [Am.]	Liegestütze {pl}
miffed [coll.]	verschnupft [ugs.] [verärgert]
vandalism	mutwillige Beschädigung {f}
excessive	ausschweifend
figment	Hirngespinst {n}
immigrant	Einwanderer {m}
superstition	Aberglaube {m} [pej.]
biased	voreingenommen
fastidious	penibel
practicality	Sachlichkeit {f}
obtrusiveness	Penetranz {f} [Aufdringlichkeit]
to provide	versorgen
to waste sth. [money, time]	etw. [Akk.] verplempern [ugs.]
omission	Versäumnis {n}
junk	Schrott {m} [ugs.]
considerable	erheblich
extract	Ausschnitt {m}
to occur	auftreten [vorkommen]
to pull oneself together	sich [Akk.] berappeln [ugs.]
attitude of refusal	Verweigerungshaltung {f}
to raise consciousness	das Bewusstsein erhöhen
superficial	oberflächlich
dishonest	verlogen
troublemaker	Querulant {m}
to act superior	erhaben tun
to hide	ausblenden
sb./sth. captivates	jd./etw. fesselt [fig.]
to be tied up with	sich knüpfen an
to charge	aufladen
deaf	taub
inconvenient	umständlich [unpraktisch]
determination	Entschlossenheit {f}
descendants	Nachfahren {pl}
nobility	Adel {m}
void	Hohlraum {m}
comprehensive  [network, gas supply]	flächendeckend
war of attrition	Zermürbungskrieg {m}
to wear sb. down [idiom]	jdn. mürbe machen
relief [easing of a burden, of responsibility etc.]	Entlastung {f}
revenge	Rache {f}
to panic	durchdrehen [ugs.]
script	Drehbuch {n}
confident [self-assured]	souverän [geh.] [selbstsicher]
scoreboard	Anzeigetafel {f}
mediator	Schlichter {m}
gain	Ertrag {m}
pattern [attr.] [e.g. book, detection]	Muster- [z. B. Buch, Erkennung]
radiotherapy	Strahlentherapie {f}
to alleviate a problem	ein Problem entschärfen
to mitigate	entschärfen [fig.]
maverick	eigenwillig
to astound	frappieren [geh.]
miserable	kläglich
to scramble	drängeln
to assess	einschätzen
to sack sb. [coll.]	jdn. entlassen
represented	vertreten
sb. worshipped	jd. verehrte
to oversleep	verpennen [ugs.]
to ravage	verwüsten
rush / inrush airing	Stoßlüftung {f}
to diminish	verringern
deliberate [on purpose]	vorsätzlich
obstacle	Hürde {f}
abortive	vergebens
to worry sb.	jdn. umtreiben [mit Unruhe erfüllen]
to get sth. open	etw. aufkriegen [ugs.]
to snap [lose self-control suddenly]	ausrasten [fig.]
yield	Rendite {f}
puzzled	verdutzt
to baffle	verdutzen [verwirren]
perspective [mental view, prospect]	Betrachtungsweise {f}
involved [complicated, tricky]	vertrackt [ugs.]
meningeal	Hirnhaut-
rudiments	Ansätze {pl}
to tilt	kippen
attendance	Anwesenheit {f}
to chant slogans	Parolen skandieren
vault [Am.] [secure storage place for valuables]	Schatzkammer {f}
to burst	zerplatzen
threatening posture	Drohkulisse {f}
to take comfort	sich [Akk.] trösten lassen
bollocks [Br.] [vulg.] [rubbish]	Schwachsinn {m} [ugs.]
atrocious	grauenhaft
antithesis	Gegenpol {m}
absolutely no ...	keinerlei ... [indekl.]
ridiculous	albern
scent	Duft {m}
virtue	Tugend {f}
frantic	krampfhaft [angestrengt, verzweifelt]
affordable	erschwinglich
blanket	pauschal
bait	Lockmittel {n}
to quit	verzichten
steam engines	Dampfmaschinen {pl}
indecent	unanständig
bloated	aufgebläht
to conserve	bewahren
abandoned  [unrestrained]	selbstvergessen
skyscraper	Wolkenkratzer {m}
conducive	dienlich
coherent	stimmig
ivory [attr.] [e.g. carving, figure, tablet, trade]	Elfenbein- [z. B. Schnitzerei, Figur, Tafel, Handel]
random	beliebig
paintwork	Lackierung {f}
to evade sb./sth.	sich [Akk.] jdm./etw. entziehen
to intervene	einschreiten
to emerge	auftauchen
little by little	nach und nach
generosity	Freigiebigkeit {f}
urgency	Dringlichkeit {f}
persistent	langlebig
creature	Wesen {n} [Geschöpf]
to maintain sth.	etw. aufrechthalten [aufrechterhalten]
lure	Reiz {m} [Verlockung]
self-control	Selbstbeherrschung {f}
confinement	Beengtheit {f}
along with	einher mit
to spur sb./sth. (on) [stimulate]	jdn./etw. beflügeln [geh.] [anspornen]
to cap it all [Br.] [coll.] [idiom]	zu allem Überfluss [Redewendung] [obendrein]
imperative	Gebot {n} [Notwendigkeit, Befehl]
to debate on a question	eine Frage erörtern
muddle	Kuddelmuddel {m} {n} [ugs.]
groundbreaking	wegweisend
threshold	Schwelle {f}
low-risk	risikoarm
to entice	verleiten
escape	Entrinnen {n}
rapid	rasant [ugs.]
concise	prägnant
dicey [coll.]	brenzlig [ugs.] [fig.]
tiled stove	Kachelofen {m}
rods	Stangen {pl}
to appease	abwiegeln
solidification	Verfestigung {f} [bei Metall]
dizzy	schwindelig
meager [Am.] [result, figures]	mau [ugs.]
catchy	eingängig
imposed	aufgebürdet
to despair	verzweifeln
incentive	Ansporn {m}
memorable	denkwürdig
to fob sth. off on sb.	jdn. mit etw. [Dat.] abspeisen
to make a find	fündig werden
maintenance	Instandhaltung {f}
to bring sb. sth.	jdm. etw. bescheren
widower	Witwer {m}
sulky	eingeschnappt [ugs.]
vice [immorality]	Laster {n}
chain of events	Ereigniskette {f}
to stall sb.	jdn. hinhalten
to lie in the eye of the beholder [fig.]	im Auge des Betrachters liegen [fig.]
heel [attr.] [e.g. bone, pain, spur]	Fersen- [z. B. Bein, Schmerz, Sporn]
to inflate	aufblasen
to whip	geißeln
nasty piece of work [coll.]	übler Kerl {m} [ugs.]
Quite possibly, but ...	Das mag sein, aber ...
to consider sth. [look at carefully]	etw. [Akk.] betrachten
vagabond	umherschweifend
upheaval	Umwälzung {f}
to be attracted to sb.	sich zu jdm. hingezogen fühlen
scared	verängstigt
outside  [observer]	außenstehend [Beobachter]
to be under the hammer	versteigert werden
rump	Steiß {m}
barking	bellend
to spin	trudeln
stoned [coll.] [drunk] [rare]	rauschig [österr.] [ugs.] [betrunken]
inappropriate	unangebracht

I give up!	Ich bin mit meinem Latein am Ende!
to get on sb.'s tits [Br.] [vulg.] [idiom]	jdm. auf die Eier gehen [ugs.] [derb] [Redewendung]
neglecting	vernachlässigend
like nobody's business [coll.] [with great speed or intensity]	wie sonst was [ugs.] [mit großer Geschwindigkeit oder Intensität]
squandered	verprasst
immature	unreif
to redeem	tilgen
flat wrong	schlichtweg falsch
womanizer	Aufreißer {m} [ugs.]
hustle [Am.] [coll.] [fraud, swindle]	Abzocke {f} [ugs.]
to make a pass at sb. [coll.] [make sexual advances at sb.]	sich [Akk.] an jdn. ranmachen [ugs.]
to abate	abklingen
fatigue	Abgeschlagenheit {f}
headache [esp. as a result of boozing]	Brummschädel {m} [ugs.]
blunder	Patzer {m} [ugs.] [Fehler]
puffy from crying	verheult [ugs.] [geschwollene Augen]
to scoop	schaufeln
ubiquitous	allgegenwärtig
to advance	voranschreiten
to disparage	herabwürdigen
to pattern	gestalten
to explore sth.	etw. [Akk.] erkunden
sth. flutters	etw. flattert
to latch	verriegeln
deceptively	täuschend
It might be that ...	Es mag sein, dass ... [Möglichkeit, Vermutung]
to champ	schmatzen
blurted out	herausgeplatzt
to be touchy	empfindlich sein
to spark	funken [Funken sprühen]

to feel sth.	etw. [Akk.] verspüren
dreadful	greulich [alt]
resilient	belastbar
strength	Festigkeit {f}
harmless	unschädlich
unquestionable	unbestreitbar
clear [unmistakable, positive]	eindeutig
annoying	störend
delay	Verzögerung {f}
neglect	Verwahrlosung {f}
declining	rückläufig
to prove sth.	etw. [Akk.] belegen [beweisen, nachweisen]
awkward [problem, question, situation]	heikel
medicine	Arznei {f}
to participate	beteiligen

wilful negligence [Br.]	bewusste Fahrlässigkeit {f}
inmate	Insasse {m}
essential	maßgeblich [wesentlich]

delicious	köstlich
one's weaker self	innerer Schweinehund {m} [fig.]
jittery [coll.]	hibbelig [ugs.]
invincible	unschlagbar
in awe	in Ehrfurcht
thrill	Nervenkitzel {m} [ugs.]
late sequelae	Spätfolgen {pl}
salvation	Erlösung {f}
approachable [of a person]	zugewandt [fig.]
to savour [Br.]	auskosten
terrain	Gelände {n}
permanent stress	Dauerstress {m}
effort	Aufwand {m}
stretch	Strecke {f}
swift	zügig
crusade	Kreuzzug {m}
It is a matter of sth.	Es handelt sich um etw.
to sugarcoat sth. [fig.]	etw. [Akk.] schönreden
stubborn	stur [ugs.] [pej.]
conspicuous	auffällig
to involve	einbeziehen
row [Br.] [coll.] [quarrel]	Zerwürfnis {n} [geh.]
guns	Geschütze {pl}
assumption	Unterstellung {f}
to see [learn from sth.]	ersehen
just now	soeben
to emerge	entstehen
to subside	abklingen [Sturm, Erregung]
serious [situation etc.]	bedenklich
a tremendous boon [fig.]	ein wahrer Segen {m} [fig.]
anticipation [prolepsis]	Vorschein {m}
squalid	verkommen
concentrated	eingedickt
devastating	verheerend
to record	verzeichnen
water jet	Wasserstrahl {m}
to elongate	recken
prone to sth. [postpos.]	anfällig für etw. [Akk.] [nachgestellt]
susceptible (to sth.)	anfällig (für etw. [Akk.])
to cut out the mistakes	die Fehler beheben
to abstain from sth. [go without]	auf etw. [Akk.] verzichten
consequences {pl}	Tragweite {f}
similarity	Gemeinsamkeit {f}
disappointing	enttäuschend
evidence {sg}	Belege {pl}
numbness	Taubheitsgefühl {n}
He's got a nerve!	Er traut sich was! [ugs.]
loophole	Schlupfloch {n}
bar [in a pub etc.]	Tresen {m} [Theke]
tame [fig.] [not exciting]	bieder
accused	angeklagt
to perceive	wahrnehmen
publisher	Verleger {m}
deep-read	sehr belesen
endurance [of pain, hardship etc.]	Erdulden {n}
Am I intruding?	Störe ich etwa?
absence	Abwesenheit {f}
obituary	Nachruf {m}
involuntarily	unwillkürlich
conclusion	Fazit {n}
worth mentioning [postpos.]	nennenswert
preventible	vermeidbar
crowds	Menschenmassen {pl}
especially	zumal
subject [email]	Betreff {m}
confidence-inspiring	vertrauenerweckend
well-known [of facts etc.]	hinlänglich bekannt
sth. will suffice	etw. wird genügen
noise	Geräusch {n}
to populate	besiedeln
availability	Verfügbarkeit {f}
[they] are regarded as	[sie] gelten als
lock	Schleuse {f}
ancillary	ergänzend [zusätzlich, Hilfs-]
more powerful	leistungsfähiger
to pour sth.	etw. schütten
to release [hormones etc.]	ausschütten [Hormone etc.]
demonstrably	nachweislich
to be designed for sb./sth.	für jdn./etw. gedacht sein
for Chrissake [Am.] [coll.] [for Christ's sake]	um Gottes willen
to master sth. [field of knowledge, subject]	etw. beherrschen [Wissens-, Sachgebiet]
to torch sth. [coll.] [a car, a building, etc.]	etw. [Akk.] abfackeln [ugs.] [in Brand stecken, niederbrennen]
to do one's Ph.D.	promovieren
to work as a DJ	auflegen
to be open [of a shop or office]	aufhaben [ugs.] [geöffnet haben (Geschäft, Behörde)]
soared	gestiegen
poll ratings	Umfragewerte {pl}
(safe) haven	Rückzugsort {m}
That's a piece of cake. [coll.] [idiom]	Das ist doch eine Kleinigkeit. [Redewendung]
to put into perspective	relativieren
to take oneself too seriously	sich selbst zu ernst nehmen
to slip	rutschen
composure	Gelassenheit {f}
to admire	bewundern
Everything's hunky-dory. [coll.]	Alles paletti. [ugs.] [auch: Alles Paletti.]
fuss	Trara {n} [ugs.]
stylish	stilvoll
the more the better	je mehr, umso besser
to move sb. to tears	jdn. zu Tränen rühren
disgust	Abneigung {f}
to badmouth sb. [coll.]	über jdn. herziehen [ugs.]
socially acceptable	salonfähig
Be my guest. [coll.]	Nur zu.
common denominator	gemeinsamer Nenner {m}
to be responsible for sth.	zuständig für etw. [Akk.] sein
kiss on the cheek	Wangenkuss {m}
pranks	Lausbubenstreiche {pl}
embodied	verkörpert
integration	Eingliederung {f}
core message	Kernbotschaft {f}
to agitate against	agieren gegen
to baptise [Br.]	taufen
interference	Eingriff {m}
consideration	Abwägung {f}
to bang on the door	gegen die Tür trommeln
here and there	vereinzelt [örtlich]
flare [pyrotechnic]	Bengalo {m} [ugs.]
to assert sth. [authority etc.]	etw. durchsetzen
kidnapped	verschleppt
ramble	Streifzug {m}
He spends money like water.	Das Geld rinnt ihm wie Sand durch die Finger.
plush	vornehm
to shed pounds [dieting]	die Pfunde purzeln lassen [ugs.] [Diät machen]
a means to an end	ein Mittel {n} zum Zweck
to be reluctant to do sth.	etw. nur ungern tun
monster	Ungeheuer {n}
to pick up sth.	etw. aufschnappen [ugs.] [(zufällig) hören]
You nailed it. [idiom]	Du hast den Nagel auf den Kopf getroffen. [fig.] [Redewendung]
action	Handlung {f}
gazer	Gaffer {m}
crusted	verkrustet
lack	Mangel {m}
nature lover	Naturliebhaber {m}
soul	Seele {f}
conscientiousness [sense of duty]	Pflichtgefühl {n}
pantry [room where food is arranged for serving]	Anrichte {f} [Raum]
mate [Br.] [coll.]	Kumpel {m} [ugs.]
hardship	Bedrängnis {f}
fighting {sg}	Gefechte {pl}
to die	ums Leben kommen
abolition	Beseitigung {f}
aggravation	Zuspitzung {f} [fig.] [Verschärfung]
participation	Teilhabe {f}
to antecede	Vorrang haben
comprehensible	nachvollziehbar
to cram ((for) sth.) [coll.]	((für) etw. [Akk.]) pauken [ugs.] [intensiv lernen]
to drill [to practise extensively]	pauken [ugs.]
excuse	Ausrede {f}
embarrassed	verlegen [betreten]
tricky	verflixt [ugs.]
taking effect	Inkrafttreten {n}
rebuke	Rüge {f}
spotlight	Scheinwerferlicht {n}
sth. goes out [fire, light]	etw. erlischt
Things are very tense.	Es herrscht Hochspannung.
to remove sth. [take sth. away]	etw. [Akk.] wegnehmen [fortnehmen, wegtun]
to deprive	entziehen
It's still in the balance.	Es steht noch auf der Kippe.
to show backbone [idiom]	Rückgrat zeigen [Redewendung]
incapacitated	lahmgelegt
effervescent	quirlig
boom	Hochkonjunktur {f}
uniqueness	Eindeutigkeit {f}
to jar sth. [building, brain]	etw. [Akk.] erschüttern
debunked	entlarvt
currents	Strömungen {pl}
to go up the creek [coll.] [idiom]	den Bach runtergehen [ugs.] [Redewendung]
especially	vornehmlich
people {pl} of that ilk	derlei Volk {n} [ugs.]
to progress	vorankommen
assessment	Abwägung {f} [Vorteile, Vorschläge]
strange [extraordinary]	außergewöhnlich
disposal	Beseitigung {f}
suitable	geeignet
sb. dared	jd. traute sich
to not have the guts [coll.]	keine Traute haben [ugs.]
I couldn't believe my ears / eyes.	Ich traute meinen Ohren / Augen nicht.
to dump sth.	etw. loswerden
etiquette guide	Knigge {m}
It was noticeable.	Es ist aufgefallen.
grief counselor [Am.]	Trauerbegleiter {m}
to create sth. [produce]	etw. [Akk.] erzeugen
passed [examination]	absolviert [Prüfung]
accessory [subordinate or supplementary part of minor importance]	Nebensache {f}
whenever possible	wann immer es möglich ist
Stop whining.	Hör auf zu jammern.
to increase	vermehren
sensational	Aufsehen erregend
estimated	beziffert
to number	beziffern
to tally	abhaken
component	Bestandteil {m}
expulsion	Vertreibung {f}
evacuation [logistics]	Abschub {m} [Versorgung]
to consider sth. [reflect upon]	etw. [Akk.] erwägen
imminent	bevorstehend
approximately <approx.>	annähernd
bustling	umtriebig
cunning	gerissen [ugs.]
recklessness	Leichtsinn {m}
to keep up [contact, deception, custom]	aufrecht halten
still	nach wie vor
weary [tired of sth.]	überdrüssig
solid results	gesicherte Ergebnisse {pl}
worn out [exhausted, tired]	mürbe [erschöpft, ausgelaugt]
to drag on [fig.] [time, work]	sich hinziehen [Zeit, Arbeit]
suggestion	Anregung {f} [Vorschlag]
monotonous	eintönig
vexation	Verdruss {m}
to cheat [with a cheat sheet]	spicken [ugs.]
former [attr.]	einstig [attr.]
malicious	bösartig
encouraging	ermutigend
sensitive	hellhörig
renovations	Umbauarbeiten {pl}
trouble [quarrel]	Zoff {m} [ugs.]
to assign sb.	jdn. beauftragen
to survey	begutachten
to argue	erörtern
balanced	ausgewogen
to emerge	zum Vorschein kommen
mental	seelisch
wellbeing	Wohlbefinden {n}
abundant	ausgiebig
budding	angehend
now and then	zwischendurch
to subjugate sb./sth.	jdn./etw. knechten [geh.] [pej.] [unterwerfen]
to shuffle	schlurfen
apparently	anscheinend
to banish	verbannen
imposition	Zumutung {f}
reasonable [justifiable, tenable]	vertretbar
to aspire	streben
to go awry	schiefgehen [ugs.] [misslingen]
waiver [relinquishment]	Verzicht {m}
room for manoeuvre [Br.]	Handlungsspielraum {m}
development [developmental process]	Entfaltung {f}
rigid	starr
to adapt	anpassen
to berate	ausschimpfen
uncertainty	Unwägbarkeit {f}
antidote	Gegengift {n}
to decommission	stilllegen
to establish	aufstellen
to build a friendship	eine Freundschaft knüpfen
to lay down	hinlegen
riddle	Rätsel {n} [Denkaufgabe; auch fig.: Geheimnis]
to sweep through sth. [e.g. storm through a valley]	durch etw. [Akk.] fegen [z. B. Sturm durch ein Tal]
insidious	schleichend
regarding	hinsichtlich <hins.> [+Gen.]
alleged	angeblich
spoiled [esp. child]	verwöhnt
scam [coll.]	Betrug {m}
previously convicted	vorbestraft
to moan	maulen [ugs.]
utterance	Äußerung {f}
to specify sth.	etw. [Akk.] präzisieren
sb. dreads sth.	jdm. graut vor etw. [Dat.]
I dread sb./sth.	mir graut vor jdm./etw.
to command	verfügen
inevitable	unausweichlich
sensible	sinnvoll
sb. examines	jd. begutachtet
Somebody beat us to it.	Jemand ist uns zuvorgekommen.
to deal with sth. [e.g. theme]	sich um etw. handeln [zum Thema haben]
legible	lesbar
fairly	einigermaßen
to sober	ernüchtern
irresponsible	verantwortungslos
to make use of sth.	etw. bemühen [geh.] [selten] [in Anspruch nehmen; zu Hilfe holen]
to slide	gleiten
to lead	leiten
for one thing ..., for another thing ...	zum einen ..., zum anderen ...
how [in what way]	inwiefern
pinched  [coll.] [stolen]	geklaut
solace	Aufmunterung {f}
now as before	nach wie vor
unmistakable	unverkennbar
to snap sb./sth.	jdn./etw. knipsen [ugs.]
unique	einmalig
to anticipate	ahnen
to edify	erbauen
just when	ausgerechnet wenn / als
tangible	greifbar
to realize	greifbar machen
to martyr sb.	jdn. zu Tode foltern
to torture	foltern
snarling	knurrend
scapegoat	Sündenbock {m}
to drill down on sth. [idiom]	etw. [Dat.] auf den Grund gehen [Redewendung]
to pursue a target	ein Ziel verfolgen
noble motives	hehre Motive {pl}
to aspire to sth.	nach etw. [Dat.] streben
to entrust	anvertrauen
editors {pl}	Redaktion {f} [Mitarbeiter]
obvious	unübersehbar
omission	Unterlassung {f}
to have an accident	verunglücken
stunned	fassungslos
cuckoo  [coll.]	durchgeknallt [ugs.]
bad breath	Mundgeruch {m}
to settle [settle in]	sich einleben
tiny little	winzig klein
signing [using sign language]	Gebärden {n}
(very) promising	vielversprechend